"a" = (/obj/structure/fans/tiny,/turf/open/floor/plating,/area/space)
"c" = (/obj/structure/chair/office{dir = 1},/turf/open/floor/plating,/area/space)
"e" = (/turf/open/floor/plating,/area/space)
"f" = (/obj/machinery/computer/helm{dir = 8},/turf/open/floor/plating,/area/space)
"g" = (/obj/effect/spawner/structure/window/reinforced,/turf/open/floor/plating,/area/space)
"h" = (/obj/structure/window/plasma/reinforced/spawner/east,/obj/structure/window/plasma/reinforced/spawner/north,/obj/structure/window/plasma/reinforced/spawner/west,/turf/open/floor/engine/air,/area/space)
"k" = (/obj/structure/window/plasma/reinforced/spawner/north,/obj/structure/window/plasma/reinforced/spawner/west,/turf/open/floor/engine/o2,/area/space)
"m" = (/obj/structure/frame/computer{dir = 8},/turf/open/floor/plating,/area/space)
"n" = (/obj/structure/window/plasma/reinforced/spawner,/obj/structure/window/plasma/reinforced/spawner/east,/turf/open/floor/engine/n2,/area/space)
"q" = (/obj/structure/window/plasma/reinforced/spawner/east,/obj/structure/window/plasma/reinforced/spawner/north,/turf/open/floor/engine/n2,/area/space)
"t" = (/obj/structure/frame/computer,/turf/open/floor/plating,/area/space)
"u" = (/obj/machinery/computer/atmos_control/tank/air_tank{dir = 8},/turf/open/floor/plating,/area/space)
"w" = (/obj/structure/table/reinforced,/turf/open/floor/plating,/area/space)
"x" = (/obj/structure/window/plasma/reinforced/spawner/east,/obj/structure/window/plasma/reinforced/spawner/north,/turf/open/floor/engine/o2,/area/space)
"y" = (/obj/machinery/door/airlock/maintenance_hatch,/turf/closed/wall/r_wall,/area/space)
"z" = (/obj/machinery/power/smes/shuttle/precharged{dir = 4},/obj/structure/window/spawner/west,/obj/machinery/door/window/northright{dir = 4},/turf/open/floor/plating,/area/space)
"B" = (/turf/closed/wall/r_wall,/area/space)
"C" = (/obj/machinery/computer/atmos_control/tank/nitrogen_tank,/turf/open/floor/plating,/area/space)
"D" = (/obj/machinery/power/shuttle/engine/electric{dir = 4},/turf/closed/wall/r_wall,/area/space)
"E" = (/obj/machinery/door/airlock/maintenance_hatch,/turf/open/floor/plating,/area/space)
"F" = (/obj/structure/window/plasma/reinforced/spawner/north,/obj/structure/window/plasma/reinforced/spawner/west,/turf/open/floor/engine/n2,/area/space)
"G" = (/obj/machinery/computer/atmos_control/tank/oxygen_tank,/turf/open/floor/plating,/area/space)
"M" = (/obj/structure/window/plasma/reinforced/spawner,/obj/structure/window/plasma/reinforced/spawner/east,/obj/structure/window/plasma/reinforced/spawner/west,/turf/open/floor/engine/air,/area/space)
"P" = (/obj/structure/chair/office{dir = 4},/turf/open/floor/plating,/area/space)
"R" = (/obj/structure/window/plasma/reinforced/spawner,/obj/structure/window/plasma/reinforced/spawner/west,/turf/open/floor/engine/o2,/area/space)
"T" = (/obj/machinery/holopad/emergency/command,/turf/open/floor/plating,/area/space)
"V" = (/obj/structure/window/plasma/reinforced/spawner,/obj/structure/window/plasma/reinforced/spawner/west,/turf/open/floor/engine/n2,/area/space)
"X" = (/turf/open/space/basic,/area/space)
"Y" = (/obj/structure/window/plasma/reinforced/spawner,/obj/structure/window/plasma/reinforced/spawner/east,/turf/open/floor/engine/o2,/area/space)
"Z" = (/obj/item/radio/intercom/wideband{dir = 4; pixel_x = -23},/turf/open/floor/plating,/area/space)

(1,1,1) = {"
XXXXXXXXXXXXXXXXXXXXBBBXXXXXXXXBBBBBBXXXXXXXXXXXXXXXXXX
XXXXXXXXXXXXXXXXXXBBBeBBBBBBBBBBeeeeBBBBBBBXXXXXXXXXXXX
XXXXBBBBBBBBXXXBBBBeeeeeeeeeeeeeeeeeeeeeeeBXXXXXXXXXXXX
XXXBBBkxFqeBXXXBeeeeeeeeeeeeeeeeeeeeeeeeeeBBXXXXXXXXXXX
XXBBeBRYVnhBXXXBeeeeeeeeeeeeeeeeeeeeeeeeeeeBBXXBgggXXXX
XBBeeBGeCeMBBBBBeeeeeeeeeeeeeeeeeeeeeeeeeeeeBBBBttggXXX
XBeeeBeeeeuBeeeeeeeeeeeeeeeeeeeeeeeeeeeeeeeeeeeBcewggXX
XBeeeyeeBBBBeeeeeeeeeeeeeeeeeeeeeeeeeeeeeeeeeeeBZePfggX
XBBBBBBEBeeeeeeeeeeeeeeeeeeeeeeeeeeeeeeeeeeeeeeBeTeemgX
XXXXXBeeeeeeeeeeeeeeeeeeeeeeeeeeeeeeeeeeeeeeeeeEeeePmgX
XXXXXBeeeeeeeeeeeeeeeeeeeeeeeeeeeeeeeeeeeBBBBBBBBBBBBBX
XBBBBBeeeeeeeeeeeeeeeeeeeeeeeeeeeeeeeeeeeBXXXXXXXXXXXXX
XDzeeBeeeeeeeeeeeeeeeeeeeeeeeeeeeeeeeeeeeBXXXXXXXXXXXXX
XDzeeEeeeeeeeeeeeeeeeeeeeeeeeeeeeeeeeeeeeBXXXXXXXXXXXXX
XDzeeBeeeeeeeeeeeeeeeeeeeeeeeeeeeeeeeeeeeBBBBBBBBBBBBBX
BBBBBBeeeeeeeeeeeeeeeeeeeeeeeeeeeeeeeeeeeeeeeeeeeeeeeBB
DzeeEeeeeeeeeeeeeeeeeeeeeeeeeeeeeeeeeeeeeeeeeeeeeeeeeeB
DzeeBeeeeeeeeeeeeeeeeeeeeeeeeeeeeeeeeeeeeeeeeeeeeeeeeeB
DzeeBeeeeeeeeeeeeeeeBBBBBBBeeBBBBBeeeeeeeeeeeeeeeeeeeeB
BBeeBeeeeeeeeeeeeeeBBXXXXXBeBBeeeBeeeeeeeeeeeeeeeeeeeeB
XBBBBeeeeeeeeeeeeeeBXXXXXXBBBeeeeBeeeeeeeeeeeeeeeeeeBBB
XXXXBBeeeeeeeeeeeeeBXXXXXXXaeeeeeEeeeeeeeeeeeeeeeeBBBXX
XXXXXBeeeeeeeeeeeeeBXXXXXXXaeeeeeBeeeeeeeeeeeeeeeeBXXXX
XXXXXBBeeeeeeeeeeBBBXXXXXXXaeeeeeBeeeBBBBBBBBeeeeeBXXXX
XXXXXXBeBBBBBBBBBBXXXXXXXXXaeeeeeBBBBBXXXXXXBBeeBBBXXXX
XXXXXXBBBXXXXXXXXXXXXXXXXXXaeeeBBBXXXXXXXXXXXBBBBXXXXXX
XXXXXXXXXXXXXXXXXXXXXXXXXXXaeBBBXXXXXXXXXXXXXXXXXXXXXXX
XXXXXXXXXXXXXXXXXXXXXXXXXXXBBBXXXXXXXXXXXXXXXXXXXXXXXXX
"}
