"aa" = (/turf/template_noop,/area/template_noop)
"ab" = (/obj/structure/sign/departments/medbay,/turf/closed/wall/mineral/titanium,/area/ship/medical)
"ac" = (/turf/closed/wall/mineral/titanium,/area/ship/medical)
"ad" = (/turf/open/floor/plating/catwalk_floor,/area/solar)
"ae" = (/obj/machinery/power/shuttle/engine/electric/premium{icon_state = "burst"; dir = 4},/turf/open/floor/plating,/area/ship/medical)
"af" = (/obj/structure/window/reinforced,/obj/structure/window/reinforced{icon_state = "rwindow"; dir = 1},/obj/machinery/door/window{icon_state = "left"; dir = 4},/obj/structure/window/reinforced{dir = 8},/obj/machinery/power/smes/shuttle/precharged{icon_state = "smes"; dir = 4},/turf/open/floor/plating,/area/ship/medical)
"ag" = (/obj/structure/cable{icon_state = "0-4"},/obj/machinery/power/terminal{dir = 8},/turf/open/floor/plasteel/telecomms_floor,/area/ship/medical)
"ah" = (/obj/machinery/light{icon_state = "tube"; dir = 1},/obj/structure/cable{icon_state = "2-8"},/turf/open/floor/plasteel/telecomms_floor,/area/ship/medical)
"ai" = (/obj/machinery/cryopod{icon_state = "cryopod-open"; dir = 8},/obj/machinery/computer/cryopod{icon_state = "wallconsole"; dir = 8; pixel_x = 24},/turf/open/floor/plasteel/telecomms_floor,/area/ship/medical)
"aj" = (/obj/structure/railing{dir = 5},/turf/open/floor/plating/catwalk_floor,/area/solar)
"ak" = (/obj/structure/railing{icon_state = "railing"; dir = 9},/turf/open/floor/plating/catwalk_floor,/area/solar)
"al" = (/obj/structure/railing{dir = 1},/turf/open/floor/plating/catwalk_floor,/area/solar)
"am" = (/obj/machinery/atmospherics/components/unary/outlet_injector/layer2,/turf/open/floor/plating/catwalk_floor,/area/solar)
"an" = (/obj/machinery/light,/obj/structure/railing{dir = 1},/turf/open/floor/plating/catwalk_floor,/area/solar)
"ao" = (/obj/machinery/atmospherics/pipe/simple/supply{icon_state = "pipe11-3"; dir = 6},/obj/structure/cable{icon_state = "1-2"},/obj/structure/cable{icon_state = "2-8"},/turf/open/floor/plasteel/telecomms_floor,/area/ship/medical)
"ap" = (/obj/machinery/atmospherics/components/unary/tank/air{dir = 4},/turf/open/floor/plasteel/telecomms_floor,/area/ship/medical)
"aq" = (/obj/machinery/light,/obj/structure/railing/corner{icon_state = "railing_corner"; dir = 4},/turf/open/floor/plating/catwalk_floor,/area/solar)
"ar" = (/obj/structure/railing/corner{icon_state = "railing_corner"; dir = 1},/turf/open/floor/plating/catwalk_floor,/area/solar)
"as" = (/turf/closed/wall/mineral/titanium,/area/ship/cargo)
"at" = (/obj/machinery/door/poddoor{id = "box_engine2"},/obj/structure/fans/tiny,/turf/open/floor/plasteel/mono/dark,/area/ship/cargo)
"au" = (/obj/machinery/door/poddoor{id = "box_engine2"},/obj/structure/fans/tiny,/obj/machinery/atmospherics/pipe/simple/scrubbers/visible/layer2,/turf/open/floor/plasteel/mono/dark,/area/ship/cargo)
"av" = (/obj/machinery/door/airlock/shuttle,/obj/machinery/atmospherics/components/binary/pump,/obj/structure/cable{icon_state = "1-2"},/turf/open/floor/plasteel/mono/dark,/area/ship/medical)
"aw" = (/obj/effect/turf_decal/industrial/defective{icon_state = "stripe"; dir = 9},/obj/machinery/door/poddoor{id = "box_engine5"},/obj/structure/fans/tiny,/turf/open/floor/plasteel/mono/white,/area/ship/bridge)
"ax" = (/obj/effect/turf_decal/industrial/defective{icon_state = "stripe"; dir = 5},/obj/machinery/door/poddoor{id = "box_engine5"},/obj/structure/fans/tiny,/turf/open/floor/plasteel/mono/white,/area/ship/bridge)
"ay" = (/turf/closed/wall/mineral/titanium,/area/ship/bridge)
"az" = (/obj/structure/sign/departments/medbay,/turf/closed/wall/mineral/titanium,/area/ship/bridge)
"aA" = (/obj/effect/spawner/structure/window/shuttle,/turf/open/space/basic,/area/ship/bridge)
"aB" = (/obj/structure/railing{dir = 8},/turf/open/floor/plating/catwalk_floor,/area/solar)
"aC" = (/obj/structure/sign/departments/medbay,/turf/closed/wall/mineral/titanium,/area/ship/cargo)
"aD" = (/obj/machinery/suit_storage_unit,/obj/item/clothing/suit/space/hardsuit/ert/med,/obj/item/tank/internals/oxygen,/obj/machinery/light{dir = 8},/turf/open/floor/plasteel/tech,/area/ship/cargo)
"aE" = (/obj/machinery/atmospherics/components/binary/pump/layer2{icon_state = "pump_map-2"; dir = 1},/turf/open/floor/plasteel/tech,/area/ship/cargo)
"aF" = (/obj/machinery/button{dir = 8; icon_state = "doorctrl"; id = "box_engine2"; pixel_x = 22},/turf/open/floor/plasteel/tech,/area/ship/cargo)
"aG" = (/obj/machinery/chem_dispenser/fullupgrade,/obj/machinery/light{icon_state = "tube"; dir = 1},/turf/open/floor/plasteel/mono/white,/area/ship/medical)
"aH" = (/obj/structure/table,/obj/item/reagent_containers/glass/beaker/bluespace,/obj/item/reagent_containers/glass/beaker/bluespace,/obj/item/reagent_containers/glass/beaker/bluespace,/obj/item/reagent_containers/glass/beaker/bluespace,/obj/item/reagent_containers/glass/beaker/bluespace,/turf/open/floor/plasteel/mono/white,/area/ship/medical)
"aI" = (/obj/machinery/chem_master,/obj/structure/window/reinforced{icon_state = "rwindow"; dir = 4},/turf/open/floor/plasteel/mono/white,/area/ship/medical)
"aJ" = (/obj/machinery/sleeper,/obj/effect/turf_decal/road/line{icon_state = "road_line"; dir = 8},/turf/open/floor/plasteel/white,/area/ship/medical)
"aK" = (/obj/machinery/vending/medical,/turf/open/floor/plasteel/white,/area/ship/medical)
"aL" = (/obj/machinery/sleeper,/turf/open/floor/plasteel/white,/area/ship/medical)
"aM" = (/obj/machinery/atmospherics/pipe/simple/supply,/obj/structure/cable{icon_state = "1-2"},/turf/open/floor/plasteel/white,/area/ship/medical)
"aN" = (/obj/structure/table/optable,/obj/machinery/defibrillator_mount/loaded{pixel_y = 25},/turf/open/floor/plasteel/white,/area/ship/medical)
"aO" = (/obj/machinery/computer/operating,/obj/structure/window/reinforced{icon_state = "rwindow"; dir = 4},/obj/machinery/light{icon_state = "tube"; dir = 1},/turf/open/floor/plasteel/white,/area/ship/medical)
"aP" = (/obj/effect/turf_decal/road/line{icon_state = "road_line"; dir = 8},/turf/open/floor/plasteel/white,/area/ship/bridge)
"aQ" = (/turf/open/floor/plasteel/white,/area/ship/bridge)
"aR" = (/obj/machinery/button{id = "box_engine5"; pixel_y = 23},/obj/structure/rack,/obj/item/gun/syringe/rapidsyringe,/obj/item/gun/syringe/rapidsyringe,/obj/item/reagent_containers/syringe/charcoal,/obj/item/reagent_containers/syringe/charcoal,/obj/item/reagent_containers/syringe/epinephrine,/obj/item/reagent_containers/syringe/epinephrine,/obj/item/reagent_containers/syringe/epinephrine,/obj/item/reagent_containers/syringe/oxandrolone,/obj/item/reagent_containers/syringe/oxandrolone,/obj/item/reagent_containers/syringe/oxandrolone,/obj/item/reagent_containers/syringe/piercing,/obj/item/reagent_containers/syringe/piercing,/obj/item/reagent_containers/syringe/piercing,/obj/item/reagent_containers/syringe/piercing,/obj/item/reagent_containers/syringe/piercing,/obj/item/reagent_containers/syringe/piercing,/obj/item/reagent_containers/syringe/antiviral,/obj/item/reagent_containers/syringe/antiviral,/turf/open/floor/plasteel/mono/white,/area/ship/bridge)
"aS" = (/obj/item/roller,/obj/item/roller,/obj/item/roller,/obj/item/roller,/obj/structure/rack,/obj/machinery/light{icon_state = "tube"; dir = 1},/obj/machinery/smartfridge/chemistry/preloaded{pixel_y = 32},/turf/open/floor/plasteel/mono/white,/area/ship/bridge)
"aT" = (/obj/machinery/computer/med_data,/obj/machinery/atmospherics/components/unary/vent_pump/on,/obj/machinery/power/apc/auto_name/west,/obj/machinery/power/terminal{dir = 8},/turf/open/floor/plasteel/mono/white,/area/ship/bridge)
"aU" = (/obj/effect/spawner/structure/window/shuttle,/turf/open/floor/plasteel/white,/area/ship/bridge)
"aV" = (/obj/item/gun/ballistic/automatic/smg/cm5,/obj/item/gun/ballistic/automatic/smg/cm5,/obj/item/gun/ballistic/automatic/smg/cm5,/obj/item/gun/ballistic/automatic/smg/cm5,/obj/item/clothing/head/helmet/marine/medic,/obj/item/clothing/head/helmet/marine/medic,/obj/item/clothing/head/helmet/marine/medic,/obj/item/clothing/head/helmet/marine/medic,/obj/item/clothing/suit/armor/vest/marine,/obj/item/clothing/suit/armor/vest/marine,/obj/item/clothing/suit/armor/vest/marine,/obj/item/clothing/suit/armor/vest/marine,/obj/item/storage/firstaid/tactical,/obj/item/storage/firstaid/tactical,/obj/item/storage/firstaid/tactical,/obj/item/storage/firstaid/tactical,/obj/item/clothing/accessory/armband/med,/obj/item/clothing/accessory/armband/med,/obj/item/clothing/accessory/armband/med,/obj/item/clothing/accessory/armband/med,/obj/item/storage/backpack/ert/medical,/obj/item/storage/backpack/ert/medical,/obj/item/storage/backpack/ert/medical,/obj/item/storage/backpack/ert/medical,/obj/item/storage/belt/medical/webbing/paramedic,/obj/item/storage/belt/medical/webbing/paramedic,/obj/item/storage/belt/medical/webbing/paramedic,/obj/item/storage/belt/medical/webbing/paramedic,/obj/item/ammo_box/magazine/smgm9mm,/obj/item/ammo_box/magazine/smgm9mm,/obj/item/ammo_box/magazine/smgm9mm,/obj/item/ammo_box/magazine/smgm9mm,/obj/item/ammo_box/c9mm,/obj/item/ammo_box/c9mm,/obj/item/ammo_box/c9mm,/obj/item/ammo_box/c9mm,/obj/item/clothing/glasses/hud/health/night,/obj/item/clothing/glasses/hud/health/night,/obj/item/clothing/glasses/hud/health/night,/obj/item/clothing/glasses/hud/health/night,/mob/living/simple_animal/hostile/mimic/crate{name = "Combat medic kit"},/turf/open/floor/plasteel/tech,/area/ship/cargo)
"aW" = (/obj/effect/landmark/start/paramedic,/obj/machinery/power/apc/auto_name/north,/obj/machinery/power/terminal{icon_state = "term"; dir = 1},/obj/structure/cable{icon_state = "0-2"},/turf/open/floor/plasteel/dark,/area/ship/cargo)
"aX" = (/obj/machinery/atmospherics/components/unary/vent_pump/on,/turf/open/floor/plasteel/dark,/area/ship/cargo)
"aY" = (/obj/machinery/atmospherics/pipe/simple/scrubbers/visible/layer2,/turf/open/floor/plasteel/dark,/area/ship/cargo)
"aZ" = (/obj/machinery/suit_storage_unit,/obj/item/clothing/suit/space/hardsuit/ert/med,/obj/item/tank/internals/oxygen,/turf/open/floor/plasteel/dark,/area/ship/cargo)
"ba" = (/obj/structure/window/reinforced,/obj/effect/landmark/start/chemist,/obj/item/storage/bag/chemistry,/obj/structure/closet/wall/white/chem{icon_state = "freezer_wall"; dir = 4; pixel_x = -31},/obj/item/clothing/glasses/sunglasses/chemical,/obj/item/clothing/glasses/sunglasses/reagent,/obj/item/clothing/gloves/color/latex/nitrile,/obj/item/clothing/head/beret/chem,/obj/item/clothing/suit/longcoat/chemist,/obj/item/gun/chem,/obj/item/storage/portable_chem_mixer,/obj/item/reagent_scanner,/turf/open/floor/plasteel/white,/area/ship/medical)
"bb" = (/obj/machinery/door/window,/turf/open/floor/plasteel/mono/white,/area/ship/medical)
"bc" = (/obj/structure/window/reinforced,/obj/structure/window/reinforced{icon_state = "rwindow"; dir = 4},/turf/open/floor/plasteel/white,/area/ship/medical)
"bd" = (/obj/effect/landmark/start/medical_doctor,/obj/effect/turf_decal/road/line{icon_state = "road_line"; dir = 8},/turf/open/floor/plasteel/white,/area/ship/medical)
"be" = (/mob/living/simple_animal/bot/medbot,/turf/open/floor/plasteel/white,/area/ship/medical)
"bf" = (/obj/effect/landmark/start/medical_doctor,/obj/machinery/atmospherics/components/unary/vent_pump/on,/turf/open/floor/plasteel/white,/area/ship/medical)
"bg" = (/obj/machinery/atmospherics/components/unary/vent_pump/on,/turf/open/floor/plasteel/white,/area/ship/medical)
"bh" = (/obj/structure/window/reinforced{icon_state = "rwindow"; dir = 4},/turf/open/floor/plasteel/white,/area/ship/medical)
"bi" = (/obj/machinery/atmospherics/components/unary/vent_pump/on,/obj/structure/cable{icon_state = "2-4"},/turf/open/floor/plasteel/white,/area/ship/bridge)
"bj" = (/obj/structure/cable{icon_state = "4-8"},/turf/open/floor/plasteel/white,/area/ship/bridge)
"bk" = (/obj/machinery/atmospherics/pipe/simple/supply{icon_state = "pipe11-3"; dir = 6},/obj/structure/cable{icon_state = "4-8"},/turf/open/floor/plasteel/white,/area/ship/bridge)
"bl" = (/obj/machinery/door/airlock/shuttle,/obj/machinery/atmospherics/pipe/simple/supply{icon_state = "pipe11-3"; dir = 8},/obj/structure/cable{icon_state = "4-8"},/turf/open/floor/plasteel,/area/ship/bridge)
"bm" = (/obj/machinery/holopad/emergency,/obj/machinery/atmospherics/pipe/simple/supply{icon_state = "pipe11-3"; dir = 9},/obj/structure/cable{icon_state = "1-8"},/turf/open/floor/plasteel/white,/area/ship/bridge)
"bn" = (/obj/machinery/computer/communications{icon_state = "computer"; dir = 8},/turf/open/floor/plasteel/mono/white,/area/ship/bridge)
"bo" = (/obj/item/storage/toolbox/mechanical,/obj/item/storage/toolbox/mechanical,/obj/item/storage/toolbox/electrical,/obj/item/storage/toolbox/electrical,/obj/item/clothing/glasses/welding,/obj/item/clothing/glasses/welding,/obj/item/clothing/gloves/color/yellow,/obj/item/clothing/gloves/color/yellow,/obj/item/multitool,/obj/item/multitool,/mob/living/simple_animal/hostile/mimic/crate,/turf/open/floor/plasteel/tech,/area/ship/cargo)
"bp" = (/obj/structure/cable{icon_state = "1-4"},/turf/open/floor/plasteel/tech/techmaint,/area/ship/cargo)
"bq" = (/obj/machinery/holopad,/obj/machinery/atmospherics/pipe/simple/supply{icon_state = "pipe11-3"; dir = 5},/obj/structure/cable{icon_state = "4-8"},/turf/open/floor/plasteel/tech/techmaint,/area/ship/cargo)
"br" = (/obj/machinery/atmospherics/pipe/simple/supply{icon_state = "pipe11-3"; dir = 4},/obj/machinery/atmospherics/pipe/manifold/scrubbers/visible/layer2{icon_state = "manifold-2"; dir = 8},/obj/structure/cable{icon_state = "4-8"},/turf/open/floor/plasteel/tech/techmaint,/area/ship/cargo)
"bs" = (/obj/machinery/atmospherics/pipe/simple/supply{icon_state = "pipe11-3"; dir = 4},/obj/machinery/atmospherics/pipe/simple/scrubbers/visible/layer2{icon_state = "pipe11-2"; dir = 8},/obj/structure/cable{icon_state = "4-8"},/turf/open/floor/plasteel/stairs{icon_state = "stairs"; dir = 8},/area/ship/cargo)
"bt" = (/obj/machinery/door/airlock/shuttle,/obj/machinery/atmospherics/pipe/simple/supply{icon_state = "pipe11-3"; dir = 4},/obj/machinery/atmospherics/pipe/simple/scrubbers/visible/layer2{icon_state = "pipe11-2"; dir = 8},/obj/structure/cable{icon_state = "4-8"},/turf/open/floor/plasteel/mono/dark,/area/ship/medical)
"bu" = (/obj/effect/landmark/start/paramedic,/obj/effect/turf_decal/road/line{icon_state = "road_line"; dir = 1},/obj/machinery/atmospherics/pipe/simple/supply{icon_state = "pipe11-3"; dir = 4},/obj/machinery/atmospherics/pipe/simple/scrubbers/visible/layer2{icon_state = "pipe11-2"; dir = 8},/obj/structure/cable{icon_state = "4-8"},/obj/structure/cable{icon_state = "2-4"},/turf/open/floor/plasteel/white,/area/ship/medical)
"bv" = (/obj/effect/turf_decal/road/line{icon_state = "road_line"; dir = 1},/obj/machinery/atmospherics/pipe/simple/supply{icon_state = "pipe11-3"; dir = 4},/obj/machinery/atmospherics/pipe/manifold/scrubbers/visible/layer2{icon_state = "manifold-2"; dir = 1},/obj/structure/cable{icon_state = "4-8"},/turf/open/floor/plasteel/white,/area/ship/medical)
"bw" = (/obj/effect/landmark/start/paramedic,/obj/effect/turf_decal/road/line{icon_state = "road_line"; dir = 1},/obj/machinery/atmospherics/pipe/simple/supply{icon_state = "pipe11-3"; dir = 4},/obj/machinery/atmospherics/pipe/simple/scrubbers/visible/layer2{icon_state = "pipe11-2"; dir = 8},/obj/structure/cable{icon_state = "4-8"},/turf/open/floor/plasteel/white,/area/ship/medical)
"bx" = (/obj/effect/turf_decal/road/line/edge{icon_state = "road_line_edge"; dir = 1},/obj/machinery/atmospherics/pipe/simple/supply{icon_state = "pipe11-3"; dir = 4},/obj/machinery/atmospherics/pipe/simple/scrubbers/visible/layer2{icon_state = "pipe11-2"; dir = 8},/obj/structure/cable{icon_state = "4-8"},/turf/open/floor/plasteel/white,/area/ship/medical)
"by" = (/obj/machinery/holopad,/obj/machinery/atmospherics/pipe/simple/supply{icon_state = "pipe11-3"; dir = 4},/obj/machinery/atmospherics/pipe/simple/scrubbers/visible/layer2{icon_state = "pipe11-2"; dir = 8},/obj/structure/cable{icon_state = "4-8"},/turf/open/floor/plasteel/white,/area/ship/medical)
"bz" = (/obj/machinery/atmospherics/pipe/manifold/supply,/obj/machinery/atmospherics/pipe/simple/scrubbers/visible/layer2{icon_state = "pipe11-2"; dir = 8},/obj/structure/cable{icon_state = "4-8"},/turf/open/floor/plasteel/white,/area/ship/medical)
"bA" = (/obj/machinery/atmospherics/pipe/manifold/supply,/obj/machinery/atmospherics/pipe/manifold/scrubbers/visible/layer2{icon_state = "manifold-2"; dir = 1},/obj/structure/cable{icon_state = "1-2"},/obj/structure/cable{icon_state = "1-8"},/obj/structure/cable{icon_state = "1-4"},/turf/open/floor/plasteel/white,/area/ship/medical)
"bB" = (/obj/machinery/door/window{icon_state = "left"; dir = 4},/obj/machinery/atmospherics/pipe/simple/supply{icon_state = "pipe11-3"; dir = 4},/obj/machinery/atmospherics/pipe/simple/scrubbers/visible/layer2{icon_state = "pipe11-2"; dir = 8},/obj/structure/cable{icon_state = "4-8"},/turf/open/floor/plasteel/white,/area/ship/medical)
"bC" = (/obj/effect/turf_decal/road/line{icon_state = "road_line"; dir = 8},/obj/machinery/atmospherics/pipe/simple/supply{icon_state = "pipe11-3"; dir = 4},/obj/machinery/atmospherics/pipe/simple/scrubbers/visible/layer2{icon_state = "pipe11-2"; dir = 8},/obj/structure/cable{icon_state = "4-8"},/turf/open/floor/plasteel/white,/area/ship/bridge)
"bD" = (/obj/machinery/atmospherics/pipe/manifold/supply,/obj/machinery/atmospherics/pipe/manifold/scrubbers/visible/layer2{icon_state = "manifold-2"; dir = 1},/obj/structure/cable{icon_state = "1-8"},/turf/open/floor/plasteel/white,/area/ship/bridge)
"bE" = (/obj/structure/window/reinforced{dir = 8},/obj/structure/table,/obj/item/scalpel/advanced,/obj/item/retractor/advanced,/obj/item/surgicaldrill/advanced,/obj/machinery/atmospherics/pipe/simple/supply{icon_state = "pipe11-3"; dir = 8},/obj/machinery/atmospherics/pipe/simple/scrubbers/visible/layer2{icon_state = "pipe11-2"; dir = 8},/turf/open/floor/plasteel/mono/white,/area/ship/bridge)
"bF" = (/obj/structure/table,/obj/item/scalpel/advanced,/obj/item/retractor/advanced,/obj/item/surgicaldrill/advanced,/obj/machinery/atmospherics/pipe/simple/supply{icon_state = "pipe11-3"; dir = 9},/obj/machinery/atmospherics/pipe/simple/scrubbers/visible/layer2{icon_state = "pipe11-2"; dir = 10},/obj/machinery/smartfridge/bloodbank/preloaded{pixel_x = 32},/turf/open/floor/plasteel/mono/white,/area/ship/bridge)
"bG" = (/obj/effect/landmark/start/chief_medical_officer,/obj/item/clothing/suit/armor/vest/marine/medium,/obj/item/clothing/head/helmet/marine,/obj/item/clothing/suit/space/hardsuit/medical/cmo,/obj/item/gun/medbeam,/obj/item/robot_module/syndicate_medical,/obj/item/clothing/glasses/hud/health/night,/obj/item/healthanalyzer/advanced,/obj/item/gun/ballistic/revolver/mateba,/obj/structure/closet/wall/blue{icon_state = "solgov_wall"; dir = 4; pixel_x = -30},/obj/item/tank/internals/oxygen,/obj/structure/chair/comfy/shuttle{desc = "STOP! YOU'RE GOING TO TEST THIS SHIP RIGHT INTO AN ICEBERG!"; dir = 4; name = "Helmsman"},/obj/item/areaeditor/shuttle,/turf/open/floor/plasteel/white,/area/ship/bridge)
"bH" = (/obj/machinery/computer/helm{dir = 8},/obj/machinery/light{dir = 4},/turf/open/floor/plasteel/mono/white,/area/ship/bridge)
"bI" = (/obj/item/storage/firstaid/o2,/obj/item/storage/firstaid/o2,/obj/item/storage/firstaid/fire,/obj/item/storage/firstaid/fire,/obj/item/storage/firstaid/brute,/obj/item/storage/firstaid/brute,/obj/item/storage/firstaid/advanced,/obj/structure/closet/crate/medical,/turf/open/floor/plasteel/tech,/area/ship/cargo)
"bJ" = (/obj/effect/landmark/start/paramedic,/turf/open/floor/plasteel/dark,/area/ship/cargo)
"bK" = (/turf/open/floor/plasteel/dark,/area/ship/cargo)
"bL" = (/obj/machinery/atmospherics/components/unary/vent_scrubber/on/layer2{icon_state = "scrub_map_on-2"; dir = 1},/turf/open/floor/plasteel/dark,/area/ship/cargo)
"bM" = (/obj/machinery/stasis{icon_state = "stasis"; dir = 4},/obj/machinery/power/apc/auto_name/west,/obj/machinery/power/terminal{dir = 8},/obj/structure/cable,/turf/open/floor/plasteel/mono/white,/area/ship/medical)
"bN" = (/obj/machinery/atmospherics/components/unary/vent_scrubber/on/layer2{icon_state = "scrub_map_on-2"; dir = 1},/turf/open/floor/plasteel/mono/white,/area/ship/medical)
"bO" = (/obj/machinery/stasis,/turf/open/floor/plasteel/mono/white,/area/ship/medical)
"bP" = (/obj/machinery/atmospherics/pipe/simple/cyan{icon_state = "pipe11-3"; dir = 6},/obj/item/reagent_containers/glass/beaker/cryoxadone,/obj/item/reagent_containers/glass/beaker/cryoxadone,/turf/open/floor/plasteel/white,/area/ship/medical)
"bQ" = (/obj/machinery/atmospherics/pipe/manifold/cyan{icon_state = "manifold-3"; dir = 1},/turf/open/floor/plasteel/white,/area/ship/medical)
"bR" = (/obj/machinery/atmospherics/pipe/simple/cyan{icon_state = "pipe11-3"; dir = 10},/turf/open/floor/plasteel/white,/area/ship/medical)
"bS" = (/obj/machinery/atmospherics/components/unary/vent_scrubber/on/layer2{icon_state = "scrub_map_on-2"; dir = 1},/obj/structure/cable{icon_state = "1-2"},/turf/open/floor/plasteel/white,/area/ship/medical)
"bT" = (/turf/open/floor/plasteel/white,/area/ship/medical)
"bU" = (/obj/structure/window/reinforced{icon_state = "rwindow"; dir = 4},/mob/living/simple_animal/bot/medbot,/turf/open/floor/plasteel/white,/area/ship/medical)
"bV" = (/obj/machinery/atmospherics/components/unary/vent_scrubber/on/layer2{icon_state = "scrub_map_on-2"; dir = 1},/turf/open/floor/plasteel/white,/area/ship/bridge)
"bW" = (/obj/machinery/atmospherics/pipe/simple/scrubbers/visible/layer2{icon_state = "pipe11-2"; dir = 5},/turf/open/floor/plasteel/white,/area/ship/bridge)
"bX" = (/obj/machinery/door/airlock/shuttle,/obj/machinery/atmospherics/pipe/simple/scrubbers/visible/layer2{icon_state = "pipe11-2"; dir = 4},/turf/open/floor/plasteel,/area/ship/bridge)
"bY" = (/obj/machinery/holopad,/obj/machinery/atmospherics/pipe/simple/scrubbers/visible/layer2{icon_state = "pipe11-2"; dir = 10},/turf/open/floor/plasteel/white,/area/ship/bridge)
"bZ" = (/obj/machinery/computer/camera_advanced{icon_state = "computer"; dir = 8},/turf/open/floor/plasteel/mono/white,/area/ship/bridge)
"ca" = (/turf/open/floor/plasteel/tech,/area/ship/cargo)
"cb" = (/obj/machinery/button{dir = 8; icon_state = "doorctrl"; id = "box_engine3"; pixel_x = 21},/turf/open/floor/plasteel/tech,/area/ship/cargo)
"cc" = (/obj/machinery/stasis{icon_state = "stasis"; dir = 4},/obj/machinery/light,/turf/open/floor/plasteel/mono/white,/area/ship/medical)
"cd" = (/obj/item/holosign_creator/medical,/obj/item/holosign_creator/medical,/obj/item/reagent_containers/medigel,/obj/item/reagent_containers/medigel,/obj/item/reagent_containers/medigel,/obj/item/reagent_containers/medigel,/obj/item/storage/belt/medical,/obj/item/storage/belt/medical,/obj/item/healthanalyzer/advanced,/obj/item/healthanalyzer/advanced,/obj/item/healthanalyzer/advanced,/obj/structure/closet/wall/white/med{icon_state = "freezer_wall"; dir = 1; pixel_y = -31},/obj/item/clothing/gloves/color/latex/nitrile,/obj/item/clothing/gloves/color/latex/nitrile,/turf/open/floor/plasteel/mono/white,/area/ship/medical)
"ce" = (/obj/machinery/atmospherics/components/unary/thermomachine/freezer{icon_state = "pipe"; dir = 1},/obj/machinery/atmospherics/components/unary/thermomachine/freezer,/turf/open/floor/plasteel/white,/area/ship/medical)
"cf" = (/obj/machinery/atmospherics/components/unary/cryo_cell{icon_state = "pod-off"; dir = 1},/turf/open/floor/plasteel/white,/area/ship/medical)
"cg" = (/obj/machinery/atmospherics/components/unary/portables_connector{icon_state = "connector_map-3"; dir = 1},/obj/machinery/portable_atmospherics/canister/oxygen,/turf/open/floor/plasteel/white,/area/ship/medical)
"ch" = (/obj/structure/cable{icon_state = "1-2"},/turf/open/floor/plasteel/white,/area/ship/medical)
"ci" = (/obj/structure/table/optable,/obj/machinery/defibrillator_mount/loaded{pixel_y = -30},/turf/open/floor/plasteel/white,/area/ship/medical)
"cj" = (/obj/machinery/computer/operating{icon_state = "computer"; dir = 1},/obj/structure/window/reinforced{icon_state = "rwindow"; dir = 4},/obj/machinery/light,/turf/open/floor/plasteel/white,/area/ship/medical)
"ck" = (/obj/machinery/button{dir = 1; icon_state = "doorctrl"; id = "box_engine4"; pixel_y = -21},/obj/machinery/rnd/production/circuit_imprinter/department/med,/turf/open/floor/plasteel/mono/white,/area/ship/bridge)
"cl" = (/obj/machinery/rnd/production/protolathe/department/medical,/obj/machinery/light,/turf/open/floor/plasteel/mono/white,/area/ship/bridge)
"cm" = (/obj/machinery/rnd/server,/obj/machinery/atmospherics/components/unary/vent_scrubber/on/layer2{icon_state = "scrub_map_on-2"; dir = 1},/obj/item/radio/intercom/wideband{dir = 4; step_x = -52; step_y = -6; pixel_x = 27; set_dir_on_move = 0},/obj/item/radio/intercom{step_x = -26; step_y = 7},/turf/open/floor/plasteel/mono/white,/area/ship/bridge)
"cn" = (/obj/structure/railing{icon_state = "railing"; dir = 10},/turf/open/floor/plating/catwalk_floor,/area/solar)
"co" = (/obj/structure/railing/corner{icon_state = "railing_corner"; dir = 8},/turf/open/floor/plating/catwalk_floor,/area/solar)
"cp" = (/obj/machinery/door/airlock/shuttle,/obj/structure/cable{icon_state = "1-2"},/turf/open/floor/plasteel/mono/dark,/area/ship/medical)
"cq" = (/obj/machinery/door/poddoor{id = "box_engine3"},/obj/structure/fans/tiny,/turf/open/floor/plasteel/mono/dark,/area/ship/cargo)
"cr" = (/obj/effect/turf_decal/industrial/defective{icon_state = "stripe"; dir = 10},/obj/machinery/door/poddoor{id = "box_engine4"},/obj/structure/fans/tiny,/turf/open/floor/plasteel/mono/white,/area/ship/bridge)
"cs" = (/obj/structure/railing,/turf/open/floor/plating/catwalk_floor,/area/solar)
"ct" = (/obj/machinery/light{icon_state = "tube"; dir = 1},/obj/structure/railing,/turf/open/floor/plating/catwalk_floor,/area/solar)
"cu" = (/obj/structure/railing{icon_state = "railing"; dir = 6},/turf/open/floor/plating/catwalk_floor,/area/solar)
"cv" = (/obj/structure/cable{icon_state = "4-8"},/obj/structure/cable{icon_state = "2-4"},/obj/structure/cable{icon_state = "1-4"},/turf/open/floor/plasteel/telecomms_floor,/area/ship/medical)
"cw" = (/obj/machinery/power/smes,/obj/structure/cable{icon_state = "0-8"},/turf/open/floor/plasteel/telecomms_floor,/area/ship/medical)
"cx" = (/obj/machinery/light{icon_state = "tube"; dir = 1},/obj/structure/railing/corner,/turf/open/floor/plating/catwalk_floor,/area/solar)
"cy" = (/obj/effect/turf_decal/industrial/defective{icon_state = "stripe"; dir = 6},/obj/machinery/door/poddoor{id = "box_engine4"},/obj/structure/fans/tiny,/turf/open/floor/plasteel/mono/white,/area/ship/bridge)
"cz" = (/obj/machinery/power/port_gen/pacman/super,/obj/structure/cable,/obj/machinery/power/terminal{icon_state = "term"; dir = 1},/turf/open/floor/plasteel/telecomms_floor,/area/ship/medical)
"cA" = (/obj/machinery/light,/obj/structure/cable{icon_state = "1-8"},/obj/structure/closet/crate/radiation,/obj/item/stack/sheet/mineral/uranium/fifty,/obj/item/stack/sheet/mineral/uranium/fifty,/obj/item/stack/sheet/metal/fifty,/obj/item/stack/sheet/glass/fifty,/turf/open/floor/plasteel/telecomms_floor,/area/ship/medical)
"cB" = (/obj/docking_port/mobile{icon_state = "pinonclose"; dir = 2},/turf/open/floor/plating/catwalk_floor,/area/solar)

(1,1,1) = {"
aaaaaaaaaaaaaaaaaaaaaaaaabacacacaccBcBaaaaaaaaaaaa
aaaaaaaaaaaaaaaaaaaaaaaeafagahaiacadadajaaaaaaaaaa
aaakalaladamadanalajaaaeafagaoapacadadaqajaaaaaaaa
akaradasatauatacacacacacacacavacacawaxayayayazaAaa
aBaCasasaDaEaFacaGaHaIaJaKaLaMaNaOaPaQaRaSayaTaUay
aBasaVaWaXaYaZacbabbbcbdbebfaMbgbhaPbibjbkblbmbnaU
aBasbobpbqbrbsbtbubvbwbxbybzbAbzbBbCbDbEbFaybGbHay
aBasbIbJbKbLaZacbMbNbObPbQbRbSbTbUaPbVaQbWbXbYbZaU
aBaCasasaDcacbaccccdbOcecfcgchcicjaPaQckclaycmaUay
cncoadascqcqcqacacacacacacaccpacaccrcyayayayazaAaa
aacncscsadadadctcscuaaaeafagcvcwacadadcxcuaaaaaaaa
aaaaaaaaaaaaaaaaaaaaaaaeafagcAczacadadcuaaaaaaaaaa
aaaaaaaaaaaaaaaaaaaaaaaaabacacacacadadaaaaaaaaaaaa
"}
